###############
  # #  # #  # #
# # ## # ## # #
#   ##   ##   #
  # #  # #  # #
# # ## # ## # #
#   ##   ##   #
  # #  # #  # #
# # ## # ## # #
#   ##   ##   #
  # #  # #  # #
# # ## # ## # #
#   ##   ##   #
  # #  # #  # #
###############
