###############
###/#/##/##////
###///##/###/##
###/#////### ##
###/##/###/////
###/##/////####
#//////###//###
#/###/#####/###
#/###//#/##/#/#
#//###///##///#
//#/#//#/##//##
###///##/#///##
#///##///###//#
//####/###/##/#
###############
