###############
###/#/##/##///M
###///##/###/##
###/#////### ##
###/##/###/////
###/##/////####
#//////###//###
#/###/#####/###
#/###//#/##/#/#
#//###///##///#
//#/#//#/##//##
###///##/#///##
#///##///###//#
E/####/###/##/#
###############
