###############
### # ## ##   M
###   ## ### ##
#####    ### ##
### ## ###
### ##     ####
#      ###  ###
# ### ##### ###
# ###  # ## # #
#  ###   ##   #
  # #  # ##  ##
###  ### #   ##
#   ##   ###  #
E #### ### ## #
###############