###############
###/#/##/##///#
###///##/###/##
###/#////###/##
###/##/###////#
###/##/////####
#//////###//###
#/###/#####/###
#/###//#/##/#/#
#//###///##///#
#/#/#//#/##//##
###///##/#///##
#///##///###//#
#/####/###/##/#
###############
